敌空空空空草空空空空空敌
草空空铁空砖空铁空砖空砖
空空空铁空砖空砖空砖空铁
敌空草砖草砖空铁空砖空敌
空空空砖空铁草砖空砖空砖
空空空水草砖空砖空水空铁
草砖空砖空水草铁空水空砖
空空空水空砖空水空砖空铁
空空空砖草砖空砖空砖空空
